1111111111111111111111111111111110101111111111111111111111001111111111111111111101010101010101011111
1111110111101001111111111111111110000111111111111111111110000011111111111111111100000000000000011111
1111000010100000011111111111111100000111110001111111111110000000001000011111100000000000000000000111
1110000000000000000110101111111100000111110000011111101110000000000000011110000000000000000000000111
1100000000000000000000001111101100000011000000000010000000000000000000001100000000000000000000000111
1000000000000000000000000110001110000000000000000000000000000000000000001100000111000000000000000011
0000000000000000000000000110000100000000000000000000000000000000000000001100000111100000000000000011
1000000000000000000000000000000000000000000000000000000000000000000000001100001111000000000000000001
0000000000000000000000000000000000000000000000000000000000000000000000001110011111000000000000000001
1000000000000000000000000000000000000000000000000000000000000000000000001111111010000000000000000001
1100000000000000000000000000000000000000000000000000000000000001000000011111111000000000000000000001
1100000000000000000000000010000000000000101000000000000000000000000000011111100000000000000000000001
1100000000000000000000011111000000000000000000000000000000000000000000111111100000000000000000000011
1000000000000000000000111111100000000000000000000000000000000000000000111110000000000000000000000111
1000000000000000000001111110000000000000000000000000000000000000000000101000010100000000000000001111
0000000000000000000011111111110000000000000000001100000000000000000000000000011110000000000000011111
1000000000000000000011111100011000000000000000011111000000000000000000000000111111100000000000111111
0000000000000000000001111110111110000000000000011111000011100000000000000000011111110000000000011111
1000000000000000000001111000011110000000000000001010000011111000000000000000011111111100000000000011
1000000000000000000001111000011111000000000000000000000011111100000000000000000000011100000000000001
1000000000001100000000111000001111000000000000000000000011111100000000000000000000011111000000000000
1100000000001110000000010000001111100000000111111110000011111000000000000000000000001111000000000000
1000111100000100000000000000000111100000011111111110000011111000000000000000000000001111111110000000
1100011110000000000000000000000111100000111111111110000011100000000000000001000000001111111111100011
1100000111000000000000000000000111100000111111100000000011000000000000000011110000001111111110000011
1100000011000000000000000000000011000000111111000000000000000000000111101111100000001111111000000011
1100000001000000000000000000000010000000000100000000000000000000111111111111000000000111110000000001
1100000000000000000000000000100010000000000000000000000000000011110001111110000000000111110000000001
1100000000000000000000000111111011100000000000011100000000001111110000111100000000000001100000000000
1110000000000000000000001111111111100000000000111111000000000111100000111110000000000001110000000001
1110000000000000000000000111111111100000000000011111000000011111100000011100000000000000000000000000
1110000000000000000000000111111111100000000000011111000000000011100000111110000000000000000000000001
1110000000000000000000000011111110000000000000000100000000000000000000011110000000000000000000000001
1100000000000000010000000001111100000000000000000000000000000000000000111100000000000000000000000001
1100000000000000111100000000111000000000000000000000001111100000000000111110000000000000000000000000
1100000000000000111111000000011100000000000000000000011111000000000011111100000000000000000000000000
1100000000000010101111100000001100000000000000000000111111000000000111111110000000000000000000000000
1100000000000110001111100000000100000000000000000000111100000000000111111111000000000000000001000000
1100000000000000000111110000000000000000000000000001111000000000000100111111000000000000000111100000
1110000000000000000111110000000000000000000000000001110000000000000000001111100000000000000111100000
1111000000000000000011110000000000000000000000000011100000000000000000011111000000000000000011110000
1111000000000000000001110000000000000000000000000011000000000000000000001100000000000000000011111000
1111000000000000000000000000000100000000000000000111000000000000000000000000000000000000000000111000
1111000000000000000000000000001110000000000000000111000000000000000000000000000000000000000000111111
1111000000000000000000000000001111111100000000000111000001000000000000000000000000000000000000000001
1111000000000000000000000000111111001110000000000110000001000000000000000000000000000000000000000011
1111000000000000000000000000111111111110000000000110000001000000000000000000000000000000111100000000
1110000000000000001100000011111110001111100000001100000000000000000000000000010000000000011100000001
1110000000000011101110000011111100001111100000001100000000000000000000000000110000000000010000000001
1000000000000011111110000111111000000111100000001000000000000000000000000001111000000000000000000001
1000000000000011111110000111110000000111100000000000000000000000000000000000100000000000000000000011
1000000000000011111110000011000000000111000000000000000000110000000000000011100000000001000000000001
1000000000000001111110000011100000000111000000000000011111110000000000000000000000000001100000000001
1100000000000001111100000001100000000110000000000000011111110000000000000110000000000111000000000001
1100000000000000111100000000100000000111000000000000001011100000000000000000000000000111000000000011
1100000000000000111000000000000000000111000000000000000000000000000000000000000000001110000000011111
1100000000000000000000000000000000000011000000000000000000000000000000000000000000001110000000011111
1110000000000000000000000000000000000001110000000000000000000000000000000000000000000100000000011111
1110000000100000000000000000000000000000011100000000000000000000000000000000000000000000000000001111
1110000000100000000000000000000000000000001100000000000000000000000000000000000000000000000000001111
1100000000101000000000000000000000000000001110000000000000000000000000000000000000000000000000000111
1100000000001010000000000000000000000000000010000000000000000000000000000000000000000001100000000111
1000000000001111100000000000000000000000000000000000000000000000000000000000000000000001110000000001
1100000000011111110000000000000000000000000000000000000000000000000000000000000000000000111000000011
1000000000000111111000000000000000000000000000000000000000000000000000000000000000000000001000000001
1100000000000011111000000000000000000001110000000000000000000000000000000000000000000000001000000011
1000000000000000111110000000000000000000111000000000000000000000000000000000000011100000000000000001
1100000000000000111110111100001110000000110000000000000010000001111000000000000111111000000010100111
1000000000000000111111111101111111100000011101010101111111111111111110000000000111111100000011111111
1110101101011111111111111111111111111001111111111111111111111111111111100000011111111111011111111111
